1 1 1 1 1 1 1 1 1 1 1 1 1 1 1 1 1 1 20 19 20 1 1 1 1 1 1 1 1 1 1 1 1 1 1 1 1 1 1 1 1 1
1 7 7 7 7 7 7 7 7 7 7 7 7 7 7 5 0 0 0 0 0 0 0 0 0 0 0 0 0 0 0 0 0 0 0 0 0 0 0 0 0 1
1 7 7 12 0 0 0 0 0 0 0 0 12 7 7 5 0 0 0 0 0 0 0 0 17 16 16 16 16 16 16 18 0 0 0 0 0 0 0 0 0 1
1 7 0 0 0 0 0 0 0 0 0 0 0 0 7 5 0 0 0 0 0 0 0 17 16 18 13 13 13 13 17 16 18 0 0 0 0 0 0 0 0 1
1 0 0 0 0 0 5 5 5 5 5 0 0 0 0 5 0 0 0 0 0 0 0 17 13 13 13 13 13 13 13 13 18 0 0 0 0 0 0 0 0 1
1 0 0 0 0 0 5 0 0 0 5 0 0 0 0 5 0 0 0 0 0 0 0 17 13 13 13 13 13 13 13 13 18 0 0 0 0 0 0 0 0 1
1 5 5 5 5 5 5 0 0 0 5 5 5 5 5 5 0 0 0 0 0 0 0 17 13 13 13 13 13 13 13 13 18 0 0 0 0 0 0 0 0 1
1 0 0 0 0 0 0 0 0 0 0 0 0 0 0 0 0 0 0 0 0 0 0 17 16 18 13 13 13 13 17 16 18 0 0 0 0 0 0 0 0 1
1 0 0 0 0 0 0 0 0 0 0 0 0 0 0 0 0 0 0 0 0 0 0 0 17 16 16 16 16 16 16 18 0 0 0 0 0 0 0 0 0 1
1 0 0 0 8 0 0 0 0 0 8 0 0 0 0 0 0 8 0 0 0 0 0 0 0 0 0 0 0 0 0 0 0 0 0 0 0 0 0 0 0 1
1 0 0 8 11 8 0 0 0 8 11 8 0 0 0 0 8 11 8 0 0 0 0 1 1 0 0 0 0 0 0 0 0 0 0 0 0 0 0 0 0 1
1 7 0 0 8 0 0 0 0 0 8 0 0 0 0 0 0 8 0 0 0 0 0 10 1 0 0 0 0 0 0 0 0 0 0 0 0 0 0 0 0 1
1 7 7 0 0 0 0 0 0 0 0 0 0 0 7 7 7 0 0 0 0 0 0 1 1 0 0 0 0 0 0 0 0 0 0 0 0 0 0 0 0 1
1 1 1 1 1 1 1 1 1 1 1 1 1 1 1 1 1 1 1 1 1 1 1 1 1 1 1 1 1 1 1 1 1 1 1 1 1 1 1 1 1 1